:::::::::::::::::::::::::::::::::::::::::::::::::::::::::::::::::::::::::::::::E::::E:::::::::::::::E:::E:::::::::E:::::::::::::::::::::E:::E::::::::::::::::::E::::E::::::::::::E:::E:::::::::::::::::::E:::E::::::::::::::E::::E:::::
::::::::P:::::::::::::::::::::::::::::::::::::::::::::::::::::::::::::::::::::::::::::::::::::::::::::::::::::::::::P:::::::::::::::::::::::::::::::::::::::::::::P::::::::::::::::::::::::::::::::::::::::::::::::::::::::::::::::::::
::::::::::::::::P::::::::::::::::::::::::::::::::::::::::::::::::::::::::::::::::::::::::::::::P::::::::::::::::::::::::::::::::::::::::::::P:::::::::::::::::::::::::::::::::::::::::::::::::::::::::::::::::::::::P::::::::::::::::::
::::::::::::P:::::::::::::::::::::::::::::::::::::::::::::::::::::::::::::::::::::::::::::::::::::::::::::P:::::::::::::::::::P:::::::::::::::::::::::::::::::::::::::::::::::::::::::::::::::P::::::::::::::::::::::::::::::::::::::::
::::::::::::::::::::::::::::::::::::::::::::::S::::::::::::::::::::::::::::::::::::::S:::::::::::::::::::::::::::::::::::::::::::::::::::::::::::::::::::::::::::::::::::::::::::::::::::::::::::::::::::::::::::::::::::::::::::::::::
123TTTTTTTTTTTTTTTTTTTTTTTTTTTTTTTTTTTTTTTTTTTTTTTTTTTTTTTTTTTTTTTTTTTTTTTTTTTTTTTTTTTTTTTTTTTTTTTTTTTTTTTTTTTTTTTTTTTTTTTTTTTTTTTTTTTTTTTTTTTTTTTTTTTTTTTTTTTTTTTTTTTTTTTTTTTTTTTTTTTTTTTTTTTTTTTTTTTTTTTTTTTTTTTTTTTTTTTTTTTTTTTTTTTF